4444444444444444444
4000111111111110004
4040404040404040404
4000000000030001004
4141404040404043414
4111003000000001014
4140404043404041414
4011110000011001014
4040414040404040414
4001111111111111004
4040404040404040404
4111111111111110004
4444444444444444444
